_______________________________________
|  0000000                000000      |
|   00000                  00000 0    |
|    000                    000 0 0   |
|     0                      00 0  00 |
|                  0          0       |
|       v          00          0      |
|                  000         0      |
|                              0      |
|0                             0      |
|00                            0      |
|000          0                0      |
|0000        00                0      |
|00000000000000                       |
|_____________________________________|